##########
##### ####
#     ####
#####P####
##### ####
##### ####
##########
