########################
##############.....#####
##############.#########
##############.#########
######.........####..B##
######...#####B.......##
######...#####.#####..##
######...#####.#########
############..P...######
########################
