########################
##############.....#####
##############.#########
##############.#########
######.........####...##
######...#####........##
######...#####.#####..##
######...#####.#########
############.....P######
########################
