########################
##############B....#####
##############.#########
##############.#########
######.........####...##
######.B.#####B......B##
######...#####.#####..##
######...#####.#########
############....<.######
########################
