########################
##############B....#####
##############.#########
##############.#########
######.........####...##
######.B.#####........##
######...#####.#####..##
######...#####.#########
############..P...######
########################
